----------
----#####-
#####-----
------####
---------X